"filename", "language", "C", "comment", "blank", "total"
"/home/ehosta/Documents/push_swap/src/instructions/px.c", "C", 0, 11, 2, 13
"/home/ehosta/Documents/push_swap/src/io/display_env.c", "C", 50, 11, 6, 67
"/home/ehosta/Documents/push_swap/src/io/display_error.c", "C", 5, 11, 3, 19
"/home/ehosta/Documents/push_swap/src/main.c", "C", 68, 11, 8, 87
"/home/ehosta/Documents/push_swap/src/moves/extract_from_stack.c", "C", 18, 11, 4, 33
"/home/ehosta/Documents/push_swap/src/moves/push.c", "C", 28, 11, 8, 47
"/home/ehosta/Documents/push_swap/src/moves/push_to_stack.c", "C", 13, 11, 4, 28
"/home/ehosta/Documents/push_swap/src/moves/reverse_rotate.c", "C", 28, 11, 4, 43
"/home/ehosta/Documents/push_swap/src/moves/rotate.c", "C", 28, 11, 4, 43
"/home/ehosta/Documents/push_swap/src/moves/swap.c", "C", 40, 11, 7, 58
"/home/ehosta/Documents/push_swap/src/stack/stack_manager.c", "C", 21, 11, 6, 38
"/home/ehosta/Documents/push_swap/src/wall/check_argv.c", "C", 92, 11, 11, 114
"Total", "-", 391, 132, 67, 590